8888888888888888888888888888
8888888888888888888888888888
8888888888888888888888888888
0000000000000000000000000000
0111111001111111111001111110
0100001001000000001001000010
0700001001000000001001000070
0111111111111111111111111110
0001001000001001000001001000
8801001000001001000001001088
0001001000001001000001001000
0111001111111001111111001110
0001000001000000001000001000
8801000001000000001000001088
8801111111111311111111111088
8801000001000000001000001088
8801000001088888801000001088
8801001111084856801111001088
8801001001088888801001001088
0001001001000000001001001000
0111111001111111111001111110
0001000000001001000000001000
8801000000001001000000001088
8801111111111001111111111088
8801000001000000001000001088
0001000001000000001000001000
0111111111111121111111111110
0100001000001001000001000010
0100001000001001000001000010
0100001001111001111001000010
0700001001000000001001000070
0100001001000000001001000010
0111111111111111111111111110
0000000000000000000000000000
8888888888888888888888888888
8888888888888888888888888888
