0000000000000
0131110111410
0100010100010
0111510161110
0010011100100
0010010100100
0111110111110
0100010100010
0111112111110
0000000000000