1111111111111111111111111111
1111111111111111111111111111
1111111111111111111111111111
0000000000000000000000000000
0111111111111001111111111110
0100001000001001000001000010
0100001000001001000001000010
0100001000001001000001000010
0111111111111111111111111110
0100001001000000001001000010
0100001001000000001001000010
0111111001111001111001111110
0000001000001001000001000000
1111101000001001000001011111
1111101001111131111001011111
1111101001000110001001011111
0000001001011111101001000000
0111111111014156101111111110
0000001001011111101001000000
1111101001000000001001011111
1111101001111111111001011111
1111101001000000001001011111
0000001001000000001001000000
0111111111111001111111111110
0100001000001001000001000010
0100001000001001000001000010
0111001111111121111111001110
0001001001000000001001001000
0001001001000000001001001000
0111111001111001111001111110
0100000000001001000000000010
0100000000001001000000000010
0111111111111111111111111110
0000000000000000000000000000
1111111111111111111111111111
1111111111111111111111111111
